9
0 1 0 7 0 9 4 0 0
0 0 3 2 0 1 0 0 0
0 0 0 6 0 4 0 7 1
2 0 0 0 7 0 0 8 0
0 0 0 0 6 0 0 1 0
0 5 0 0 4 0 0 0 9
6 8 0 5 9 7 0 0 0
0 0 0 3 2 6 0 0 0
0 0 0 4 1 8 5 0 0