9
0 0 0 2 9 4 3 8 0
0 0 0 1 7 8 6 4 0
4 8 0 3 5 6 1 0 0
0 0 4 8 3 7 5 0 1
0 0 0 4 1 5 7 0 0
5 0 0 6 2 9 8 3 4
9 5 3 7 8 2 4 1 6
1 2 6 5 4 3 9 7 8
0 4 0 9 6 1 2 5 3