9
6 1 5 2 9 4 3 8 7 
3 9 2 1 7 8 6 4 5 
4 8 7 3 5 6 1 2 9 
2 6 4 8 3 7 5 9 1 
8 3 9 4 1 5 7 6 2 
5 7 1 6 2 9 8 3 4 
9 5 3 7 8 2 4 1 6 
1 2 6 5 4 3 9 7 8 
7 4 8 9 6 1 2 5 3 
