9
4 7 9 0 1 2 0 0 0
0 3 0 6 7 0 0 1 0
1 0 2 9 0 0 7 0 4
0 0 0 0 4 0 5 6 8
6 8 0 0 0 0 0 0 2
2 0 0 8 6 3 0 9 0
3 4 0 0 8 0 9 0 0
0 2 0 4 0 0 8 0 0
8 0 1 5 2 0 4 0 0
