9
9 8 4 0 0 0 0 0 0
0 0 2 5 0 0 0 4 0
0 0 1 9 0 4 0 0 2
0 0 6 0 9 7 2 3 0
0 0 3 6 0 2 0 0 0
2 0 9 0 3 5 6 1 0
1 9 5 7 6 8 4 2 3
4 2 7 3 5 1 8 9 6
6 3 8 0 0 9 7 5 1